NO ./images/north.png
SO ./images/south.png
WE ./images/west.png
EA ./images/east.png

F 220,100,0
C 225,30,0

0 1111111111111111111111111
  1000000000110000000000001
  1011000001110000000000001
  10010000000000000000000001
110111111011000001110000001000001111 
1000000000110000011S0111111011111
11111011111111011100000010001
11110111111111011101010010001
11000000110101011100000010001
10000000000000011000000100001
10000001000000000000000000001
10000001110101011111011110011
10110111 1110101 101111010001
11111111 1111111 111111111111
